GGGGGGGGGGGGGGGGGGGGGGGGGGGGGGGGGGGGGGGGGGGGGGGGGGGGGGGGGGGGGGGGG
GGGGGGGGGGGGGGGGGGGGGGGGGGGGGGGGGGGGGGGGGGGGGGGGGGGGGGGGGGGGGGGGG
GGGGGGGWWWWWWWWWWWWWWWWWWWWWWWWWWWWWWWWWWWWWGGGGGGWWWWWWWWWWWWWWW
GGGGGGGWGGGGGG *GGGGGGGGGGGGGGGGGGOGGGGGOGGGGGGGGGGGOGGGGG GGGGGG
GGGGGGGWGGGGGGGGGOGGGG GGGOGGGGGGGGOOGGGG  GGGGG*GGGGGGGGGGGGGGGG
GGGGGGGWGGG GGGGGGOGGGGGGGGGGGGGGGGGGGGOGGGOGGGGGG GGGGGGGoGGGGGG
GGGGGGGWGGGGGOOGGGGGGGGGGGGOG  GGGGGGGGOGGGGGOGGGGGGGGGGGGGGGGGGG
GGGGGGGWGGOGGG  GGGGGGOGGGGGGGGOGGGGGGGGGOGGGGGGG  GGGGGOGGGGOGGG
GGGGGGGWGGGGGGGOOGGGGGGGGGGGGGGG GGGGGGGGGGGGGGGGGGGGGGGGGGGGGGGG
GGGGGGGWGGGGGGGGG GGGGGGO*GGGGGGGGGOGGGGGGGG  GGGGGGGGGGGGGGGGGGG
GGGGGGGWGGGGGGGGGGOO*GGGGGGGGGGGGGGGGGG*OGGGGGG  GGGGGGGGGGGGGGGG
GGGGGGGWGGGGGGGGGGGGGGGOGGGGGGGGGGGGGGGGGGGGGGGGGGGGGGGGGGGGGGGGG
GGGGGGGWGGGGOGGGGGGGGGG*GGGGOOGGGGGGG GGGGGGGGGGGGGGG OGGGGGGGGGG
GGGGGGGWGGGGOGGGGGGGGGGGGOGGGGGGGGGGGG*GGGGGGGGGG GG*GOGGGGGGGGGG
GGGGGGGWGGGGOGGGGGGGOOGGGGGG*GGGGGGGGGGGGGGGG GGGGGGGGOGGGGGGGGGG
GGGGGGGWGGG* GOGGGGGGOOGGGGGGGGGGGGG GGGGGGGGGGGGGGGG OGGGGGGGGGG
GGGGGGGWWWWWWWWWWWWWWWWWWWWWWWWWWWWWWWWWWGGGWWWWWWWWWWWWWWWWWWWWW
GGGGGGGGGGG*GGGGGGGGGGGGGGGGGGGGGGGGGGGGGGGGGGGGGGGGGGGGGGGGGGGGG
GGGGGGGGGGGGGGGGGGGGGGGGGGGGGGGGGGGGGGGGGGGGGGGGGGGGGGGGGGGGGGGGG
GGGGGGGGGGGGGGGGGGGGGGGGGGGGGGGGGGGGGGGGGGGGGGGGGGGGGGGGGGGGGGGGG